id=boss_room_01
display_name=Boss Room 01
type=BossRoom
boss_room=true

[spawn_points]
from_module_05,72,14

[enemy_spawns]
ground_enemy_basic,28,14
ground_enemy_basic,47,14
flying_enemy_basic,23,8
flying_enemy_basic,52,8

[npc_placements]

[transitions]
boss_room_01,module_05,from_boss_room_01,73,14

[terrain]
============================================================================
=                                                                          =
=                                                                          =
=            ========                            ========                  =
=                                                                          =
=      =========                              =========                    =
=                                                                          =
=                         =============                                    =
=                                                                          =
=                                      =============                       =
=                                                                          =
=             ==========                              ==========           =
=                                                                          =
=                            ========                                      =
=                                                                          =
============================================================================
=                                                                          =
============================================================================
