id=module_04
display_name=Module 04
type=CombatRoom
boss_room=false

[spawn_points]
from_module_03,67,12
from_module_05,14,2

[enemy_spawns]
ground_enemy_basic,20,6
ground_enemy_basic,39,8
ground_enemy_basic,66,12
flying_enemy_basic,46,7
flying_enemy_basic,50,10

[npc_placements]

[transitions]
module_04,module_03,from_module_04,73,12
module_04,module_05,from_module_04,21,2

[terrain]
============================================================================
=                                                                          =
=                                                                          =
=        ================                                                  =
=                       ====                                               =
=            ===============                                               =
=                       ====                                               =
=                 =============                                            =
=                       ====                            ====               =
=                                 =============         ====               =
=           =============  ====                    ====                    =
=                   ================            ============               =
=                               ====                    ====               =
=                       =============                   ====================
=                               ====                    ====               =
=                               ====     =================                 =
=                                                                          =
=                                                                          =
============================================================================
