id=module_01
display_name=Module 01
type=CombatRoom
boss_room=false

[spawn_points]
from_spawn_village,4,15
from_module_02,61,15

[enemy_spawns]
ground_enemy_basic,16,15
ground_enemy_basic,30,15
flying_enemy_basic,38,9
ground_enemy_basic,52,15
flying_enemy_basic,61,7

[npc_placements]

[transitions]
module_01,spawn_village,from_module_01,2,15
module_01,module_02,from_module_01,58,15

[terrain]
============================================================================
=                                                                          =
=                                                                          =
=                            ========                                      =
=                                                                          =
=            =========                         ========                    =
=                                                                          =
=                                   =========                              =
=       =========                                                      =====
=                                                                          =
=                      =========                      =========            =
=                                                                          =
=           =========                         =========                    =
=                                                                          =
=                                                       =========          =
=                                                                          =
============================================================================
=                                                                          =
============================================================================
