id=module_05
display_name=Module 05
type=CombatRoom
boss_room=false

[spawn_points]
from_module_04,18,14
from_boss_room_01,3,14
from_spawn_village_shortcut,72,14

[enemy_spawns]
ground_enemy_basic,20,11
ground_enemy_basic,9,11
ground_enemy_basic,60,9
flying_enemy_basic,35,6
flying_enemy_basic,50,6

[npc_placements]

[transitions]
module_05,module_04,from_module_05,18,15
module_05,boss_room_01,from_module_05,2,14
module_05,spawn_village,from_module_05_shortcut,73,14

[terrain]
============================================================================
=                                                                          =
=                                                                          =
=                                                                          =
=                                                                          =
=                              ==                                          =
=                              ==             ==                           =
=                              ==             ==                           =
=             ==================================================           =
=                                      ==             ==                   =
=      ============        =========   ==             == =======           =
=           ==          ==             ==             ==        ==         =
=    ========= ===========             ==             ==        == ======= =
=           ==          ==                            ==        ==         =
=           ==          ==                            ==        ==         =
============================================================================
=                                                                          =
============================================================================
