id=random_event_01
display_name=Random Event 01
type=EventRoom
boss_room=false

[spawn_points]
from_module_03,50,2

[enemy_spawns]
ground_enemy_basic,22,14
ground_enemy_basic,41,14
ground_enemy_basic,60,14
ground_enemy_basic,57,11
flying_enemy_basic,31,8
flying_enemy_basic,56,5

[npc_placements]
event_marker,43,11

[transitions]
random_event_01,module_03,from_random_event_01,50,2

[terrain]
============================================================================
=                                                                          =
=                                                                          =
=                                            ===========                   =
=                                                                          =
=                                                                          =
=                                    ===========     ===========           =
=                                                                          =
=                                                                          =
=                           =============     =============                =
=                                                                          =
=                                                                          =
=                =============   =============   =============             =
=                                                                          =
=                                                                          =
============================================================================
=                                                                          =
============================================================================
