id=spawn_village
display_name=Spawn Village
type=SpawnVillage
boss_room=false

[spawn_points]
player_start,8,14
from_module_01,72,14
from_module_03_shortcut,36,14
from_module_05_shortcut,3,14

[enemy_spawns]

[npc_placements]
village_chief,11,12
doctor,27,10
merchant,45,8

[transitions]
spawn_village,module_01,from_spawn_village,74,14
spawn_village,module_03,from_spawn_village_shortcut,37,14
spawn_village,module_05,from_spawn_village_shortcut,2,14

[terrain]
============================================================================
=                                                                          =
=                                                                          =
=                                                                          =
=                                                                          =
=                                                                          =
=                                                                          =
=                                                                          =
=                                                                          =
=                                      ==============        =======       =
=                                                                          =
=                    ==============                         ============   =
=                                                                          =
=     ============                                      ==============     =
=                                                                          =
============================================================================
=                                                                          =
============================================================================
